0,0,0,0,0,0,0,0,0,0,0,0,0,0,0,0
0,0,0,0,2,1,1,1,1,1,1,2,1,1,1,1
0,2,0,0,1,0,0,0,0,0,0,1,0,0,0,0
0,1,0,0,1,0,0,0,0,0,0,1,0,0,0,0
0,2,1,1,2,0,0,0,0,0,0,2,1,1,1,1
0,1,0,0,1,0,0,0,0,0,0,1,0,0,0,0
0,2,0,0,1,0,0,0,0,0,0,1,0,0,0,0
0,0,0,0,2,1,1,1,1,1,1,2,1,1,1,1
0,0,0,0,0,0,0,0,0,0,0,0,0,0,0,0
routes
15,1,LUULDLU
15,7,LDDLULD
